Width : 46
Height : 39
Player X : 3
Player Y : 4
Objectives : CA 42,36 TL 120 TC 200 
Weather : 1
150 150 150 150 150 150 150 150 150 150 150 150 150 150 150 150 150 150 150 150 150 150 150 150 150 150 150 150 150 150 150 150 150 150 150 150 150 150 150 150 150 150 150 150 150 150 
100 100 100 100 100 100 100 100 100 100 100 100 100 100 100 100 100 100 100 100 100 100 100 100 100 100 100 100 100 100 100 100 100 100 100 100 100 100 100 100 100 100 100 100 100 150 
121 100 100 120 100 100 120 100 100 120 100 100 120 100 100 120 100 100 120 100 100 120 100 100 100 100 100 100 100 100 100 100 120 120 120 120 120 100 100 100 100 100 160 100 100 150 
100 100 100 100 100 100 100 100 100 100 100 100 100 100 100 100 100 100 100 100 100 100 100 100 100 100 100 100 100 100 100 100 120 100 100 100 120 120 100 100 100 100 100 100 100 150 
120 100 120 100 120 100 110 100 110 100 110 100 120 100 110 100 110 100 120 100 110 120 100 100 100 100 100 100 100 100 100 100 120 100 100 100 120 120 120 120 100 100 100 100 100 150 
100 100 100 100 100 100 100 100 100 100 100 100 100 100 100 100 100 100 100 100 100 120 100 100 100 100 100 100 200 200 100 100 120 100 100 100 200 200 120 120 120 100 100 100 100 150 
100 100 100 100 100 100 100 100 100 100 100 100 100 100 100 100 100 100 100 100 100 100 100 100 100 100 100 200 200 200 100 100 120 100 200 200 200 200 100 120 120 100 100 100 100 150 
100 100 100 100 100 100 100 100 100 100 100 100 100 100 100 100 100 100 100 100 100 120 100 100 100 100 100 200 200 200 100 100 120 100 200 200 200 100 100 100 120 120 100 100 100 150 
100 100 100 100 100 100 100 100 100 100 100 100 100 100 100 100 100 100 100 100 100 120 100 100 100 100 100 200 200 100 100 100 120 200 200 200 200 100 120 120 120 120 120 120 120 150 
100 100 100 100 100 100 100 100 100 100 100 100 100 100 100 100 100 100 100 100 100 100 100 100 100 100 100 100 100 100 100 100 120 200 200 200 100 100 120 100 100 100 100 100 120 150 
100 100 100 100 100 100 100 100 100 100 100 100 100 100 100 100 100 100 100 100 100 120 100 100 100 100 100 100 100 100 100 100 100 100 100 100 100 100 100 100 100 100 100 120 100 150 
120 100 120 100 120 100 120 100 120 100 120 100 120 100 120 100 120 100 120 100 120 100 120 100 120 100 120 100 120 100 120 100 120 100 120 100 120 100 120 100 100 100 120 120 100 150 
100 120 100 120 100 120 100 120 100 120 100 120 100 120 100 120 100 120 100 120 100 120 100 120 100 120 100 100 100 100 100 200 100 100 100 100 100 100 100 100 100 120 120 100 100 150 
120 100 120 100 120 100 120 100 120 100 120 100 120 100 120 100 120 100 120 100 120 100 120 100 120 100 100 100 100 100 200 200 200 100 100 100 100 100 100 100 120 120 100 100 100 150 
100 120 100 120 100 120 100 120 100 120 100 120 100 120 100 120 100 120 100 120 100 120 100 120 100 100 100 100 100 100 200 200 200 100 100 100 100 100 100 100 120 100 100 100 100 150 
100 100 100 100 100 100 100 100 100 100 100 100 100 100 100 100 100 100 100 100 100 100 100 100 100 100 100 100 100 100 200 200 200 100 100 100 100 100 100 120 120 100 100 100 100 150 
150 150 150 150 150 150 150 150 150 150 150 150 150 150 150 150 150 150 150 150 140 140 140 140 140 100 100 100 200 200 200 200 200 100 100 100 100 100 100 120 100 100 100 100 100 150 
100 100 100 100 100 100 122 120 120 120 100 100 100 100 100 100 100 100 100 100 140 140 140 140 140 100 100 200 200 200 200 200 200 100 100 100 120 120 120 120 120 100 120 100 100 120 
100 100 100 100 100 100 120 100 100 120 120 100 100 100 100 100 100 100 100 100 140 140 140 140 140 100 200 200 200 200 200 100 100 100 120 120 120 150 150 100 120 100 120 100 100 120 
100 100 100 100 100 100 120 100 100 100 120 100 100 100 100 100 100 100 100 100 100 100 100 100 150 100 200 200 200 200 100 100 100 120 120 150 150 150 100 100 120 100 120 100 100 120 
120 120 120 120 120 120 120 120 120 120 120 120 120 120 120 120 120 120 120 120 120 120 100 100 150 100 200 200 100 100 100 100 120 120 150 150 100 100 100 100 120 100 120 100 100 120 
120 120 120 120 100 100 100 100 120 100 100 100 100 200 200 200 200 100 100 100 100 120 100 100 150 100 200 200 100 100 100 120 120 150 150 100 100 100 100 100 120 100 120 100 100 120 
120 120 120 100 100 100 100 100 120 100 100 200 200 200 100 100 100 100 100 100 100 120 100 100 150 100 200 200 100 120 120 120 150 150 100 100 100 120 120 120 120 100 120 120 120 120 
120 000 120 100 100 100 100 100 120 100 100 200 100 100 100 100 100 100 100 100 100 120 100 100 150 100 200 200 100 120 150 150 150 100 100 100 120 120 120 120 120 100 120 120 120 120 
120 120 120 100 100 100 100 100 120 100 100 100 100 100 100 100 120 100 100 100 100 120 100 100 150 100 200 200 100 120 150 150 100 100 100 100 120 120 120 120 120 100 120 120 000 120 
120 120 120 100 120 120 120 120 120 120 120 120 120 120 120 120 120 100 100 100 100 120 100 100 150 100 200 200 100 120 150 100 100 100 100 120 120 120 000 120 120 100 120 120 120 120 
120 120 120 120 120 120 120 120 120 120 120 120 120 120 120 120 120 100 100 100 100 120 100 100 150 100 200 200 100 120 150 100 100 100 100 120 120 120 120 120 120 100 120 120 120 120 
120 120 120 120 120 100 100 120 120 100 100 100 200 100 100 120 120 120 120 120 120 120 120 122 150 100 200 200 100 120 150 100 100 100 120 120 120 120 120 120 120 100 120 120 120 120 
150 100 100 100 120 100 100 120 120 100 100 200 200 100 100 120 100 100 100 100 100 120 120 100 150 100 200 200 100 120 150 100 100 120 120 120 120 120 120 120 120 100 120 120 120 120 
150 100 100 100 120 100 100 120 120 100 100 100 100 100 100 120 100 100 100 100 100 120 100 100 150 100 100 100 120 100 150 100 120 120 120 120 120 120 120 120 120 100 120 120 120 120 
150 100 100 120 120 120 100 120 120 100 100 120 120 120 120 120 100 100 100 100 100 120 100 100 150 100 100 120 100 100 150 100 120 120 120 120 120 120 120 120 120 100 120 120 120 120 
150 100 100 120 000 120 100 120 120 120 120 120 120 120 120 120 100 200 100 100 100 120 100 100 150 100 120 100 100 100 150 100 120 120 120 120 120 100 100 100 100 100 120 120 120 120 
150 100 100 120 120 120 100 100 100 100 100 200 200 100 100 120 100 200 200 100 120 120 100 200 100 120 100 100 100 100 150 100 120 120 120 120 120 120 120 120 120 120 120 120 120 120 
150 100 150 150 150 100 100 100 100 100 100 200 200 200 100 120 120 100 100 120 120 100 200 200 112 100 100 100 100 100 150 100 120 120 120 120 120 120 120 120 120 120 120 120 120 120 
150 100 150 100 150 100 200 200 200 200 200 200 200 100 100 120 120 120 120 120 100 200 200 100 110 100 100 100 100 100 150 100 120 120 120 120 120 120 120 120 120 120 120 120 120 120 
150 100 150 100 150 100 200 200 200 200 200 200 100 100 120 120 120 100 100 200 200 200 100 100 110 100 100 100 100 100 150 100 120 120 120 000 120 120 120 120 120 120 000 120 120 120 
150 100 150 150 150 100 100 100 100 100 100 100 100 120 120 000 120 100 100 100 100 100 100 100 110 100 100 100 100 100 150 100 120 120 120 120 120 120 120 120 120 120 120 120 120 120 
150 100 100 100 100 100 100 100 100 100 100 100 120 120 120 120 120 100 100 100 100 100 100 100 110 100 100 100 100 100 150 100 120 120 120 120 120 120 120 120 120 120 120 120 120 120 
150 150 150 150 150 150 150 150 150 150 150 120 120 120 120 120 120 120 120 120 120 120 120 120 120 100 100 100 100 100 150 100 120 120 120 120 120 120 120 120 120 120 120 120 120 120 
