sdWidth : 40
Height : 30
Player X : 0
Player Y : 0
Objectives : CA 36,26 SH 14,12 TC 25  
Weather : 1
0 0 0 0 111 100 110 100 200 200 200 200 200 100 120 120 120 120 0 0 0 40 40 150 150 150 150 150 150 150 140 140 140 150 150 150 150 150 150 150 
0 0 0 0 0 100 100 100 100 110 100 110 200 110 120 120 120 120 0 0 0 0 40 140 150 150 150 100 100 100 100 100 100 100 100 100 150 150 150 150 
0 0 0 0 0 0 110 100 110 100 100 100 200 200 100 120 120 120 120 0 0 0 0 140 140 140 100 100 100 100 100 100 100 100 100 100 100 100 150 150 
0 0 0 0 0 0 0 100 100 100 100 100 100 120 100 100 120 120 120 0 0 0 0 100 140 100 120 100 120 100 100 100 100 100 100 100 160 100 100 150 
0 0 0 0 0 0 0 0 110 110 110 100 100 120 120 120 120 120 120 0 0 0 0 100 100 100 100 100 100 100 100 100 100 100 100 100 100 100 100 150 
0 0 0 0 0 0 0 0 0 0 0 100 100 120 120 120 120 120 120 120 0 0 0 0 100 100 100 100 120 100 120 100 100 100 100 100 100 100 100 100 
0 0 0 0 0 0 0 0 0 0 0 0 0 100 120 120 120 120 120 120 120 0 0 0 0 200 200 100 100 100 100 100 100 100 100 100 100 100 100 100 
0 0 0 0 0 0 0 0 0 0 0 0 0 0 100 100 100 100 100 100 100 100 0 0 0 0 0 200 100 100 120 100 120 100 100 100 100 100 100 100 
111 0 0 0 0 0 0 0 0 0 0 0 0 0 0 0 0 0 0 0 0 0 0 0 0 0 0 200 200 200 100 100 100 100 100 100 100 100 100 110 
100 100 0 0 0 0 0 0 0 0 0 0 0 0 0 200 0 0 0 0 0 0 0 0 0 0 0 0 0 0 200 100 120 100 120 100 100 100 100 100 
110 200 110 0 0 0 0 0 0 0 0 100 100 100 100 100 0 0 0 0 0 0 0 0 0 0 0 0 0 0 200 100 100 100 100 100 100 100 100 110 
100 200 110 0 0 0 0 0 0 0 100 100 100 100 100 100 100 100 100 100 100 100 0 0 0 0 0 0 0 0 0 100 100 100 120 100 110 100 110 110 
100 200 110 110 0 0 0 0 0 0 100 100 100 100 120 120 100 100 100 100 100 100 100 200 200 200 200 0 0 0 0 0 0 100 100 100 100 100 100 100 
100 200 100 110 110 0 0 0 0 100 100 100 120 120 120 120 100 120 110 120 120 100 110 110 100 100 100 200 0 0 0 0 0 0 100 100 100 100 100 110 
100 200 100 100 100 120 0 0 0 100 100 120 120 120 100 100 100 100 110 110 100 100 100 100 100 110 110 100 200 200 0 0 0 0 0 100 100 100 100 110 
150 100 200 100 100 120 0 0 0 100 100 120 120 100 100 100 100 100 100 100 100 100 100 100 100 100 100 110 100 100 200 0 0 0 0 0 100 100 100 100 
150 100 200 100 100 120 120 0 0 100 110 120 110 200 200 200 200 200 200 200 200 100 100 100 100 100 100 110 110 100 100 200 0 0 0 0 100 100 100 110 
150 100 100 200 100 120 120 0 0 0 100 110 100 200 133 200 110 100 100 100 200 200 200 200 200 200 100 100 110 110 100 200 0 0 0 0 0 100 100 100 
150 140 100 200 100 100 120 120 0 0 0 100 100 200 200 200 110 110 100 100 100 100 100 100 100 200 200 200 100 110 100 210 0 0 0 0 0 100 100 110 
150 150 140 200 100 100 120 120 120 0 0 0 200 200 100 100 100 110 110 100 100 100 100 100 100 100 100 100 100 100 100 100 110 0 0 0 0 110 100 100 
150 150 140 200 100 100 100 120 120 0 0 0 0 200 100 100 100 100 100 100 100 120 100 110 110 110 120 120 100 100 110 100 110 0 0 0 0 100 100 100 
150 150 140 100 200 100 100 120 120 200 0 0 0 0 0 100 100 100 110 120 140 150 0 0 0 0 0 120 120 100 100 100 100 0 0 0 0 110 100 110 
150 150 100 100 200 100 100 100 100 100 200 0 0 0 0 0 100 100 100 100 100 0 0 0 0 0 0 0 120 100 100 100 110 0 0 0 0 0 100 110 
150 140 100 100 100 200 100 100 100 100 100 200 200 0 0 0 0 0 100 150 0 0 0 0 0 0 0 0 0 0 100 100 100 110 0 0 0 0 100 100 
150 140 100 100 100 200 100 100 100 100 100 100 100 200 200 0 0 0 0 0 0 0 0 0 0 0 0 0 0 0 0 0 0 111 0 0 0 0 100 110 
150 100 100 100 200 200 200 100 100 100 100 100 100 100 100 200 200 0 0 0 0 0 0 200 200 200 200 200 0 0 0 0 0 0 0 0 0 0 0 100 
150 100 100 200 200 200 200 200 200 100 100 100 100 100 100 100 100 110 110 110 110 110 100 100 100 100 100 200 200 0 0 0 0 0 0 0 0 0 0 111 
100 100 200 200 200 200 100 100 100 200 200 200 200 100 100 100 100 100 110 110 110 100 100 100 100 100 100 100 200 200 200 0 0 0 0 40 40 40 0 0 
200 200 200 200 100 100 110 110 110 110 110 100 100 200 200 200 200 200 200 200 200 200 200 200 150 150 150 150 140 140 140 0 0 40 40 40 0 0 0 0 
200 200 200 100 110 110 110 110 110 110 110 110 100 100 100 100 100 100 100 100 100 150 150 150 150 150 150 150 150 150 140 140 140 150 50 0 0 0 0 0 
