Width : 50
Height : 50
Player X : 3
Player Y : 45
Objectives : CA 1,22 SH 42,22 TL 090 
Weather : 2
123 123 123 120 120 110 210 210 200 200 210 200 200 210 210 210 110 120 120 120 120 120 120 120 110 110 110 210 210 210 210 100 120 120 120 100 120 120 120 100 100 100 100 100 120 120 120 150 150 150 
123 123 120 120 100 200 100 100 100 100 100 100 110 100 100 100 200 210 200 200 110 100 100 100 100 200 200 200 100 100 200 210 200 210 200 200 200 210 200 200 210 110 110 100 100 120 120 120 150 150 
123 120 120 100 200 100 110 100 110 100 120 120 120 120 110 100 110 110 100 100 200 100 100 110 200 200 120 120 120 120 100 110 100 200 110 110 100 100 100 100 200 200 100 110 100 100 120 120 120 150 
120 120 100 200 100 110 100 110 100 120 120 120 120 120 100 100 100 100 100 120 120 200 200 210 100 120 120 120 120 120 100 100 100 100 200 100 120 120 120 100 100 210 200 100 100 110 100 120 120 150 
100 100 200 100 100 100 100 100 100 110 100 110 100 100 110 110 100 100 120 120 120 200 100 100 120 120 120 120 100 110 100 110 100 100 200 100 120 150 120 120 100 100 200 100 110 100 100 110 120 120 
110 210 100 100 200 100 120 110 100 100 100 100 100 110 100 100 120 120 120 100 100 110 110 110 120 120 120 100 100 110 200 100 100 100 210 100 120 150 150 150 120 100 100 200 100 100 100 110 120 120 
210 100 100 110 100 110 120 120 120 120 100 100 110 100 100 120 120 120 100 100 100 100 100 110 100 100 100 200 110 100 120 120 120 120 200 100 120 120 150 150 120 120 100 200 100 100 100 100 110 120 
200 100 120 110 110 200 120 120 120 120 100 110 100 100 100 120 120 110 100 100 100 100 100 100 100 110 110 100 120 120 150 150 150 120 100 100 100 120 120 150 150 120 100 200 200 100 110 100 100 120 
210 100 120 100 100 100 110 120 120 120 100 100 100 100 120 120 120 100 100 200 110 100 110 100 100 100 100 120 150 150 150 150 120 120 100 210 100 100 120 150 150 120 110 100 200 110 100 100 100 120 
210 100 110 120 120 100 110 100 120 120 100 100 110 100 120 120 100 110 200 100 100 100 100 120 120 120 120 150 150 150 120 120 120 100 100 200 100 120 120 150 150 120 110 100 200 100 100 100 100 120 
200 100 110 120 120 200 200 100 120 120 100 100 100 120 120 120 100 100 100 100 100 120 120 150 150 150 150 150 120 120 120 100 100 110 100 200 100 120 120 120 150 120 110 100 210 100 100 110 100 120 
110 200 110 120 120 100 100 110 120 120 100 110 120 120 120 120 100 110 100 110 120 150 150 150 120 120 120 120 120 100 100 110 100 100 100 200 100 120 120 120 150 120 110 100 200 200 100 110 100 120 
100 100 210 110 120 100 110 200 100 100 100 100 120 120 120 100 100 110 100 100 120 120 120 120 120 100 100 100 100 100 100 100 120 120 100 100 100 100 120 150 100 120 110 100 100 200 100 100 100 120 
120 100 100 100 120 120 100 210 100 100 100 120 120 120 120 100 100 110 100 100 100 100 110 110 110 100 110 100 100 110 100 120 120 150 150 110 110 120 150 150 120 100 100 100 100 200 100 100 100 120 
120 120 120 200 100 120 100 100 100 110 120 120 120 120 120 100 200 100 110 100 110 100 100 100 100 110 100 100 110 100 120 120 150 150 120 100 100 100 150 100 100 110 100 100 110 200 110 100 100 120 
140 120 120 100 110 120 120 100 210 120 120 120 120 100 110 100 100 100 100 110 100 100 100 000 000 100 100 100 100 100 120 150 150 150 120 100 110 100 100 110 100 100 100 100 100 200 200 100 100 120 
150 120 120 120 100 100 120 100 100 120 110 120 100 200 200 100 100 120 120 120 100 110 110 000 000 100 110 100 120 120 150 150 150 150 120 100 100 110 100 100 100 100 100 100 100 100 210 100 100 120 
150 140 120 120 120 100 120 120 100 100 110 100 100 210 100 100 120 120 120 120 120 100 100 110 100 100 110 100 120 150 150 150 120 120 100 200 200 100 100 100 110 100 100 100 100 100 200 100 100 120 
150 150 140 120 120 100 100 200 200 110 110 110 100 100 100 120 120 120 150 120 120 100 100 100 110 100 100 100 120 150 150 110 110 110 100 200 100 100 100 100 100 110 110 110 100 110 200 110 100 120 
150 150 140 140 120 120 100 100 100 110 100 100 120 120 120 150 150 150 150 150 120 100 100 110 110 100 100 120 150 150 150 120 110 100 100 200 110 100 100 100 120 000 000 110 100 100 200 100 100 120 
150 150 150 140 140 120 120 110 100 100 100 120 120 150 150 150 150 240 120 120 100 110 100 100 100 100 120 120 150 150 120 100 100 100 200 200 100 110 100 120 120 000 000 110 100 100 200 100 110 120 
150 150 150 150 140 140 120 120 120 120 120 120 150 150 150 150 220 120 120 100 100 100 110 100 100 100 120 150 150 120 120 100 100 210 200 100 100 100 120 120 120 000 000 110 100 100 200 100 100 120 
150 150 150 150 150 150 120 120 120 120 120 150 150 150 150 250 120 100 100 110 100 110 100 110 120 120 120 150 150 120 120 100 100 200 100 110 100 120 120 120 120 110 000 110 100 100 210 100 100 120 
110 150 150 150 150 150 150 120 120 120 150 150 150 150 100 120 120 100 100 200 100 100 110 100 100 120 120 120 120 110 100 110 100 100 120 120 120 120 120 100 100 110 110 100 100 100 200 100 100 120 
110 110 150 150 150 150 150 150 150 150 150 150 150 250 120 100 100 110 200 200 100 100 110 100 100 110 100 100 100 110 100 100 120 120 120 120 120 120 100 100 100 100 100 210 200 200 200 100 110 120 
100 110 110 110 110 150 150 150 150 250 250 250 120 120 120 100 110 100 200 100 100 100 100 100 100 100 100 100 100 100 100 120 120 120 120 120 120 100 110 100 200 200 200 200 100 100 210 100 100 120 
100 100 100 100 110 110 110 150 150 140 140 120 120 120 100 100 100 210 210 120 120 120 120 120 120 110 110 110 150 150 140 120 120 120 120 120 100 100 100 200 200 110 100 100 100 110 200 100 120 120 
100 160 100 100 110 100 110 150 150 150 140 140 120 120 100 100 100 200 100 120 120 140 140 150 150 150 150 150 150 120 120 120 120 120 100 110 100 200 200 200 100 100 130 110 100 110 200 110 120 120 
100 100 100 110 100 100 110 150 150 150 150 140 120 120 100 110 100 210 100 100 100 120 120 120 120 120 120 120 120 120 120 120 100 100 100 200 200 200 100 110 100 120 120 100 100 100 100 200 120 120 
120 100 100 100 100 100 110 150 150 150 150 140 140 120 110 100 100 200 210 100 110 100 100 110 100 100 110 100 200 200 200 100 110 210 200 100 110 100 100 120 120 120 140 100 120 110 100 200 120 120 
120 100 100 120 110 100 110 110 150 150 150 150 140 120 000 110 110 100 200 200 100 100 110 100 100 100 100 100 100 100 100 100 110 100 100 100 100 120 120 120 120 120 100 100 100 140 200 200 120 120 
120 120 100 100 100 100 110 110 110 150 150 150 140 140 000 000 000 100 110 100 100 200 200 200 100 100 100 100 120 120 120 110 120 120 120 120 120 120 120 120 120 100 110 110 100 100 210 100 120 120 
120 120 100 100 100 100 100 100 110 110 150 150 150 140 140 000 110 100 110 100 110 100 100 100 110 140 120 120 120 120 120 120 120 120 120 120 120 120 110 100 100 110 100 100 100 100 200 110 120 120 
120 120 100 110 100 110 100 100 120 110 150 150 150 150 140 140 100 100 100 100 100 110 110 110 100 150 100 140 150 150 120 120 120 120 120 120 000 000 100 100 120 100 100 140 110 100 200 100 120 120 
120 120 100 100 100 100 110 120 120 120 120 120 150 150 150 140 140 110 110 110 110 110 100 140 150 150 150 120 120 120 120 120 120 100 000 000 000 100 110 110 100 110 100 100 100 100 200 110 120 120 
120 120 100 100 110 100 100 120 120 120 120 120 120 120 150 150 150 150 150 150 150 150 150 150 150 150 150 140 120 140 000 000 000 000 000 000 110 100 100 100 110 100 110 100 100 100 200 140 100 120 
120 120 100 100 100 100 120 120 120 100 100 140 100 120 120 150 150 150 150 150 150 150 150 150 120 120 120 140 140 140 000 000 000 000 100 110 100 100 100 110 100 100 110 100 110 100 200 100 100 120 
120 120 100 120 100 110 120 120 120 100 100 100 100 100 120 120 120 120 120 120 120 120 120 120 110 110 100 100 100 110 110 100 100 110 100 110 100 110 100 100 100 100 100 110 110 100 200 100 120 120 
120 100 100 100 100 100 120 120 100 100 100 100 110 100 100 110 100 100 100 100 100 120 120 110 100 100 100 100 100 100 100 110 100 100 100 100 100 100 100 110 100 110 100 100 100 100 210 100 100 120 
120 100 100 100 100 120 120 120 100 100 120 100 140 100 100 100 100 100 110 100 100 120 110 110 100 100 100 110 100 100 100 100 110 110 100 100 100 110 120 120 120 100 100 100 110 200 100 120 100 120 
100 100 110 100 100 120 120 100 140 100 100 100 100 100 100 100 100 100 140 100 120 110 110 100 100 100 120 110 110 100 110 110 100 100 100 100 110 120 120 120 120 100 110 100 200 100 100 120 100 120 
110 100 110 100 120 120 120 100 100 100 100 100 100 120 120 100 100 100 100 100 120 120 110 110 100 100 120 120 120 120 100 100 100 100 120 120 120 120 120 100 100 100 100 200 200 100 100 100 120 120 
100 100 100 100 120 120 100 100 110 100 120 100 120 120 100 110 100 110 100 120 120 120 100 110 100 100 100 120 120 120 120 120 120 120 120 120 120 120 100 100 100 100 200 210 100 100 140 120 120 120 
100 110 100 120 120 100 100 100 100 100 100 120 120 100 100 100 100 100 120 120 120 120 110 110 110 100 100 100 100 120 120 120 120 120 120 120 120 100 100 100 100 200 100 100 100 100 100 120 120 120 
100 100 120 120 100 100 140 110 100 100 120 120 100 100 110 100 100 120 120 120 120 120 120 120 110 100 100 100 100 100 100 100 100 100 100 100 100 100 110 100 200 100 100 100 100 100 100 120 120 120 
100 100 100 100 100 100 100 100 120 120 120 120 100 100 100 100 120 120 120 120 120 120 100 100 100 100 100 110 100 110 110 100 100 200 200 200 200 200 100 100 210 100 100 100 140 100 120 120 120 120 
110 100 100 110 110 100 100 100 120 120 120 120 100 100 100 120 120 100 110 100 100 100 110 110 100 100 100 100 110 100 100 110 100 110 100 100 100 110 100 100 100 100 110 120 120 120 120 120 120 150 
100 100 100 100 100 100 100 120 120 120 120 100 100 100 140 100 100 100 100 100 100 100 100 100 120 100 100 100 110 100 100 100 100 100 110 100 100 100 100 100 100 100 100 120 120 120 120 120 120 150 
100 100 110 100 120 120 120 120 120 120 100 100 110 140 100 100 100 100 100 110 120 110 100 100 100 100 100 100 100 120 120 120 120 120 120 120 120 120 120 120 120 120 120 120 120 120 120 120 150 150 
100 100 100 100 100 120 120 120 120 120 120 100 100 100 100 110 100 100 100 100 100 100 110 100 100 100 120 120 120 120 120 120 120 120 120 120 120 120 120 120 120 120 120 120 120 150 150 150 150 150 