Width : 20
Height : 20
Player X : 0
Player Y : 0
Objectives : CA 3,17 TL 50 TC 10 
Weather : 1
150 150 150 150 140 100 110 100 110 100 110 120 120 120 140 150 150 150 150 150 
150 150 140 100 100 100 100 100 100 100 110 110 120 120 120 140 140 140 140 150 
150 140 100 160 100 100 113 100 100 100 100 110 110 110 120 120 120 120 140 140 
150 140 100 100 100 100 100 100 100 100 100 100 100 110 110 120 120 120 120 120 
150 100 100 100 100 100 100 100 100 100 100 100 100 100 100 100 100 110 120 120 
140 0 40 0 0 100 100 100 100 100 100 100 100 100 110 100 100 110 100 120 
120 200 200 200 40 50 0 100 100 100 100 100 100 100 100 100 110 100 100 100 
120 100 100 100 200 200 40 0 0 100 100 100 100 100 100 100 100 100 100 100 
100 100 100 100 100 100 100 100 0 0 0 100 100 100 100 100 110 110 100 100 
100 100 100 100 100 100 100 100 0 0 0 0 140 100 100 100 100 100 110 100 
150 100 100 100 100 100 100 100 100 100 0 0 0 0 100 100 100 100 100 110 
150 100 100 100 100 150 150 100 100 100 100 100 0 0 0 200 100 100 100 100 
150 100 100 100 100 150 150 100 100 100 100 100 100 140 0 200 100 100 100 110 
140 100 100 100 100 150 150 100 100 100 140 100 100 100 0 200 100 100 100 110 
140 100 100 100 100 140 100 100 100 120 120 100 100 100 200 200 100 100 110 110 
200 100 100 100 100 100 100 110 140 110 100 100 100 100 100 100 100 100 110 140 
200 100 100 100 100 100 100 110 110 110 100 100 100 100 100 110 100 110 140 150 
200 200 100 100 100 100 100 100 100 100 100 100 100 100 120 110 140 140 140 150 
200 200 200 100 100 100 100 120 120 120 120 120 120 120 120 140 140 150 150 150 
200 200 200 200 200 200 120 120 120 120 120 120 120 120 140 140 150 150 150 150 
