Width : 60
Height : 60
Player X : 29
Player Y : 0
Objectives : CA 29,59 TC 70 SH 29,29 
Weather : 1
110 100 100 110 110 100 100 100 110 100 100 100 110 100 100 120 100 100 100 100 100 110 100 100 110 100 200 200 200 160 100 100 100 100 100 200 210 200 000 120 100 100 100 120 100 110 110 100 110 100 110 110 110 110 110 110 110 100 100 140 
100 100 110 150 100 100 110 100 110 100 100 100 110 100 110 120 100 100 100 100 100 100 110 100 100 100 200 200 100 100 100 100 100 100 200 200 000 000 000 120 100 100 100 120 100 100 100 100 110 100 100 100 110 100 110 100 110 100 110 140 
100 110 110 150 100 100 100 100 100 100 110 100 100 100 100 120 110 110 100 110 110 100 110 100 100 210 200 100 100 100 100 100 100 200 200 000 000 000 110 120 100 110 100 120 100 100 100 100 100 100 100 100 100 100 100 100 100 100 110 140 
100 150 150 150 100 110 100 150 100 100 100 150 150 150 150 120 150 150 150 150 150 150 150 110 100 200 200 150 150 150 150 150 150 150 150 150 120 120 120 110 100 100 100 120 100 100 100 150 150 150 150 150 150 150 150 150 100 100 100 150 
100 110 100 150 100 100 100 150 100 100 100 150 100 100 110 100 100 100 100 100 100 100 100 150 110 200 200 200 100 100 100 100 100 110 110 150 100 100 100 100 100 100 100 100 100 100 100 100 110 100 100 150 100 100 100 100 100 100 110 140 
100 100 100 150 100 100 100 150 100 110 100 150 100 100 110 100 100 100 110 100 100 100 100 150 100 110 110 200 200 200 200 210 200 110 100 150 100 100 100 100 100 110 100 110 100 100 100 100 100 100 100 150 100 110 100 100 100 100 100 140 
100 110 100 150 100 100 100 120 100 100 100 150 100 100 100 100 100 100 100 100 100 100 100 150 100 100 110 100 100 100 110 100 200 100 100 150 100 100 100 110 100 100 100 100 100 100 100 100 100 100 100 150 100 100 110 100 110 100 110 140 
110 100 100 150 110 110 100 120 120 120 120 120 120 120 120 120 120 120 120 120 100 100 110 120 120 120 150 150 150 150 150 150 200 100 100 150 120 120 120 120 120 120 120 150 150 150 150 150 120 120 120 120 100 100 100 150 150 150 150 150 
100 100 100 110 100 100 100 150 100 100 100 150 100 100 100 100 110 100 100 100 100 110 100 150 100 100 100 150 100 100 100 100 200 100 100 150 100 100 110 100 100 100 100 150 100 100 100 150 100 100 100 100 110 100 110 100 110 100 110 140 
110 100 100 110 100 100 100 150 110 100 100 150 100 100 110 100 100 100 110 100 100 100 110 150 100 110 100 150 110 100 100 210 200 000 110 150 110 100 100 100 100 110 100 150 100 100 100 150 100 100 100 110 100 100 100 100 100 100 100 140 
100 100 100 100 100 100 100 150 100 100 100 150 100 100 100 100 100 100 100 100 100 100 100 150 100 100 100 150 100 100 200 000 000 000 100 150 100 100 100 100 100 110 100 150 100 110 100 150 100 100 100 100 100 100 100 140 100 100 110 140 
100 110 100 120 120 120 120 120 100 110 100 120 110 210 100 120 120 120 120 120 120 120 120 120 100 110 100 150 150 150 150 000 000 000 150 150 100 100 100 150 100 100 100 120 100 100 100 120 120 120 120 120 120 120 120 150 110 100 110 150 
100 100 100 150 100 100 110 150 110 100 100 150 100 100 100 150 100 100 100 110 110 110 110 150 100 100 100 100 100 100 210 200 100 100 100 110 100 100 110 150 110 100 100 150 110 100 100 150 100 100 100 100 100 100 100 150 100 100 100 140 
110 110 100 150 100 100 100 150 100 100 100 150 100 110 110 150 100 100 100 100 100 110 110 150 100 100 100 110 100 100 100 200 100 100 100 100 100 110 100 150 100 100 110 150 100 100 100 150 100 100 110 100 100 100 100 150 100 100 110 140 
100 100 100 150 100 100 100 150 110 100 100 150 100 100 100 150 100 100 100 100 100 100 110 150 100 100 100 100 100 100 100 200 110 100 110 100 100 100 100 150 100 100 100 150 100 100 110 150 100 100 100 100 100 100 100 150 100 100 100 140 
100 100 100 120 110 100 110 120 100 100 100 120 120 120 120 120 100 100 100 120 120 120 120 150 150 150 150 150 150 150 150 200 100 100 100 150 150 150 150 140 200 100 100 150 100 100 100 150 100 100 100 150 150 150 150 150 110 100 110 150 
100 110 100 120 100 100 100 100 100 100 110 100 100 100 100 100 110 100 100 200 000 000 000 150 110 110 110 100 110 110 120 200 100 110 100 150 140 140 140 120 000 200 100 100 110 100 100 100 100 110 100 120 100 100 110 150 100 100 110 140 
150 100 100 120 100 100 200 200 100 100 100 100 110 100 100 100 100 100 100 100 210 000 210 150 110 110 100 100 100 100 120 210 100 100 100 150 140 110 140 120 000 210 100 100 100 100 110 110 100 100 100 120 100 100 100 150 100 100 100 140 
150 150 100 120 100 100 200 140 100 100 100 100 100 100 100 100 100 110 100 100 100 200 100 150 110 100 100 100 100 100 120 200 100 100 100 150 110 110 100 120 000 000 200 110 100 100 100 100 100 100 100 120 100 110 100 150 100 100 110 140 
150 150 150 120 110 110 110 120 120 120 120 120 120 120 150 150 150 150 150 150 150 150 150 110 100 100 100 150 150 150 150 250 250 150 150 150 110 100 100 150 150 150 150 150 150 150 150 150 150 150 150 140 100 100 100 140 100 100 110 150 
150 100 100 120 100 100 100 100 100 100 100 100 100 100 100 100 110 100 100 100 110 110 100 110 100 100 100 140 110 210 200 210 100 110 100 120 100 100 100 100 100 100 100 100 100 100 100 100 100 100 110 110 100 100 110 100 100 100 100 140 
100 100 110 120 100 100 100 110 100 100 110 100 100 110 100 100 100 100 100 110 100 100 100 100 100 100 140 140 100 200 100 100 100 100 100 120 100 100 100 100 110 100 100 100 100 100 110 100 100 100 100 100 100 100 100 100 100 100 110 140 
100 100 200 150 100 100 100 100 100 100 100 100 100 100 110 100 100 110 100 100 100 100 100 100 100 140 140 140 200 200 200 100 100 100 100 120 100 110 100 110 100 100 100 100 100 100 100 100 100 100 100 100 100 110 100 100 100 100 100 140 
100 110 200 150 100 110 100 120 120 120 150 150 100 100 100 150 100 100 100 150 150 150 150 150 150 150 150 150 000 000 000 150 150 150 150 150 100 100 110 120 100 100 100 120 120 120 120 120 120 120 120 120 120 100 100 100 140 110 150 150 
100 100 200 150 100 100 100 150 100 100 100 110 100 100 100 150 100 110 100 100 100 100 100 120 100 110 110 110 200 200 200 210 110 110 110 120 100 110 100 120 100 100 100 100 100 100 100 150 140 140 110 140 150 100 100 100 100 100 140 140 
100 110 200 150 140 100 100 150 110 100 100 100 110 100 200 150 100 100 110 110 100 110 110 120 100 100 200 200 200 200 200 200 200 100 100 120 100 100 100 120 100 100 110 100 100 110 100 150 140 100 100 140 150 100 110 100 100 110 140 140 
100 200 150 150 140 100 100 150 110 110 110 110 110 100 200 150 100 110 100 100 100 100 100 120 110 200 200 110 110 110 110 110 200 200 110 120 100 100 140 150 140 100 100 100 100 100 100 150 100 100 110 100 150 100 100 100 100 100 110 140 
210 150 150 150 140 120 120 120 120 120 120 120 120 120 150 150 100 100 100 150 150 150 150 150 100 200 110 110 110 110 110 110 110 200 100 150 150 150 150 150 150 150 150 150 150 150 150 140 100 100 100 100 120 120 120 120 100 100 100 150 
200 200 200 150 140 200 100 100 100 100 100 150 100 100 100 100 110 100 100 100 100 100 200 000 210 200 110 110 120 120 120 110 110 200 210 000 200 100 140 150 140 100 100 100 100 100 100 100 100 100 110 100 100 100 100 150 100 100 110 140 
100 200 200 150 140 200 100 110 100 100 100 150 100 100 100 100 100 100 110 100 100 100 210 000 200 200 110 120 120 130 120 120 110 200 200 000 200 100 100 120 100 100 100 100 110 100 100 100 100 100 100 100 100 100 100 150 100 100 100 140 
100 110 110 150 140 200 100 100 100 100 100 150 100 100 110 100 100 100 100 100 100 100 200 000 210 200 110 120 120 200 120 120 110 200 210 000 100 100 100 120 100 110 110 100 100 100 100 110 100 100 100 100 110 100 110 150 100 100 110 140 
100 100 140 150 140 200 100 120 150 150 150 140 100 100 100 150 150 150 150 150 150 150 150 120 100 200 200 110 120 200 120 110 200 200 110 150 150 150 150 120 100 100 100 140 120 120 120 120 120 120 120 120 100 100 110 140 100 100 100 150 
100 100 140 150 200 100 100 120 100 100 100 100 100 100 100 120 100 100 100 100 100 100 110 120 100 100 200 200 200 200 200 200 200 100 100 120 100 110 100 100 110 100 100 150 100 100 100 100 100 100 100 100 100 100 100 100 100 100 100 140 
110 100 100 150 200 100 110 120 100 110 100 100 100 100 100 120 110 100 110 100 110 100 110 120 120 100 100 110 100 200 200 110 110 100 110 120 110 100 110 100 100 100 140 150 110 100 110 100 100 110 100 100 110 110 100 100 100 100 110 140 
100 100 110 120 200 110 100 120 120 200 200 200 200 200 200 150 100 110 100 100 100 110 100 110 120 120 100 100 100 200 200 100 100 100 100 120 100 110 100 100 140 140 140 150 100 100 100 100 100 100 100 100 100 100 100 110 110 100 110 140 
100 100 100 150 140 100 100 120 120 110 000 000 000 110 150 150 150 150 150 150 110 100 110 150 150 150 150 150 150 150 150 150 150 150 150 150 100 110 100 150 150 150 150 150 110 100 100 150 150 150 150 150 100 110 110 110 150 150 150 150 
100 110 110 150 140 100 100 120 120 110 000 000 000 110 120 150 140 100 110 150 100 110 100 120 100 100 100 100 100 100 200 120 200 200 200 200 100 100 100 150 100 100 100 100 110 100 110 120 100 100 100 120 100 100 100 100 100 100 100 140 
100 100 200 150 140 100 100 140 120 120 110 110 110 120 120 150 140 100 110 150 100 100 100 120 100 100 100 110 100 100 200 120 210 200 110 100 110 100 140 150 100 100 100 100 110 100 100 120 100 100 100 120 110 100 110 100 100 100 100 140 
100 100 210 150 140 100 100 140 120 120 120 120 120 120 120 140 100 100 100 150 100 100 100 120 100 110 100 100 100 100 200 120 200 110 100 100 100 140 140 150 100 110 100 100 100 110 100 120 100 110 100 150 100 100 100 200 100 100 100 140 
100 110 200 150 140 100 100 110 140 140 140 120 120 120 140 110 100 110 100 110 150 150 150 110 100 100 100 150 150 150 150 250 210 100 100 150 150 150 150 150 100 100 110 150 150 150 150 150 100 100 100 150 100 100 110 000 200 100 100 150 
100 200 110 150 140 100 100 100 100 100 100 100 100 100 100 100 100 100 100 150 100 100 100 100 110 100 100 120 100 200 200 200 100 110 100 120 100 110 100 100 110 100 100 120 140 100 100 100 110 100 110 110 100 100 210 000 000 200 100 140 
110 200 150 150 140 100 100 100 100 110 100 100 110 100 100 110 100 100 100 150 100 100 110 100 100 100 100 120 100 200 200 100 100 100 100 120 100 100 100 110 100 100 100 120 110 110 100 100 100 100 100 100 100 100 200 150 000 200 140 140 
120 200 150 140 140 110 100 100 100 100 100 100 100 100 100 100 100 110 100 150 100 100 000 000 000 110 100 120 100 200 100 100 100 100 100 120 100 110 100 100 100 100 100 150 140 100 100 110 100 100 100 100 100 100 110 150 000 140 140 140 
120 150 140 140 100 100 100 110 120 120 120 120 120 120 120 120 150 120 150 150 150 150 000 000 000 150 150 150 150 150 150 150 150 150 150 150 100 100 100 120 120 120 120 150 150 150 150 150 150 120 120 120 100 100 100 110 150 150 150 150 
120 150 150 140 140 110 100 150 110 100 100 100 100 100 100 120 100 100 100 120 120 100 110 110 110 100 100 110 100 210 110 110 100 100 100 100 100 100 100 100 100 100 110 120 100 100 100 100 100 100 100 100 100 100 100 100 110 110 120 140 
120 140 150 150 150 150 150 150 110 100 100 110 100 100 110 150 100 110 100 120 100 100 100 100 100 100 100 110 100 200 100 100 110 100 110 100 100 110 110 100 110 100 100 120 100 100 110 100 110 100 100 110 100 100 100 100 100 110 110 140 
120 100 100 100 140 140 140 150 100 100 100 100 100 100 100 150 100 100 100 150 110 100 100 100 100 100 100 100 100 200 100 100 100 100 110 110 100 110 100 100 100 110 100 120 100 100 100 200 200 100 100 100 100 100 110 110 100 100 100 140 
110 100 100 110 100 100 140 150 100 100 100 120 200 200 200 150 100 100 100 150 100 110 100 150 150 150 150 150 150 150 150 150 150 150 150 150 100 100 100 120 100 100 100 120 100 100 200 000 000 140 120 120 120 120 150 150 100 100 110 150 
100 110 100 110 100 110 140 150 100 110 100 120 200 210 200 150 100 100 100 100 100 100 100 120 100 100 100 120 120 200 100 100 100 100 100 120 100 100 100 120 100 110 100 100 100 100 110 200 200 100 100 100 100 100 100 150 100 100 100 140 
110 100 100 100 100 100 100 150 110 100 100 120 200 000 000 150 100 110 100 100 100 110 100 120 100 110 110 120 100 200 100 110 100 110 100 120 100 100 110 120 100 100 110 110 100 100 100 100 100 110 100 100 100 100 100 150 100 100 110 140 
110 100 100 100 100 110 100 150 100 100 100 120 000 000 000 150 100 100 100 100 110 100 100 120 100 100 100 150 100 110 100 100 100 100 100 120 100 100 100 120 100 100 100 100 100 100 100 100 100 100 100 100 100 100 100 150 100 110 100 140 
100 100 100 150 100 100 110 150 100 100 110 120 110 110 110 120 100 100 110 120 100 100 100 120 100 100 100 120 200 200 100 120 100 100 100 110 120 120 120 120 150 150 150 140 150 150 150 120 120 110 110 110 150 150 150 110 100 100 100 150 
110 100 110 150 100 100 100 150 100 100 110 100 100 100 100 100 110 100 100 120 100 100 100 100 100 110 100 150 200 100 140 120 100 100 100 100 100 110 100 110 100 110 110 150 100 110 110 100 100 100 100 100 110 100 100 100 100 110 100 140 
100 100 100 150 140 100 110 150 100 110 100 100 110 100 110 100 100 100 100 120 100 100 110 100 100 100 100 150 210 140 100 120 100 100 100 110 100 100 100 110 100 100 100 150 110 000 000 200 100 100 100 100 100 100 100 100 100 100 140 140 
100 100 110 150 140 100 110 150 100 100 100 100 100 100 100 100 100 100 100 120 100 100 100 100 100 120 100 140 200 100 100 150 100 100 100 100 100 100 100 100 100 100 110 150 000 000 000 200 100 110 100 100 120 100 100 110 100 100 110 140 
100 100 100 150 140 100 100 150 110 110 110 150 100 100 100 110 120 120 120 110 100 100 100 100 120 140 150 140 200 140 100 120 150 150 150 150 120 120 120 120 100 100 100 110 150 150 120 120 100 100 100 120 120 120 150 150 150 150 110 150 
100 100 110 150 140 100 100 111 100 100 100 150 100 110 100 120 100 100 100 100 110 100 100 140 140 150 120 120 210 140 110 150 110 100 100 100 100 100 100 100 100 100 100 110 110 100 100 100 110 100 100 100 100 100 100 100 100 100 110 140 
100 100 100 150 140 100 100 100 100 110 100 150 100 100 100 120 100 110 100 100 100 120 120 140 150 150 200 200 200 200 100 150 100 110 100 110 100 110 110 100 100 110 100 100 100 110 100 110 100 100 110 100 110 100 110 100 110 100 111 140 
111 100 110 140 140 100 100 100 100 100 110 150 100 100 100 120 100 100 100 100 120 120 140 150 150 150 200 200 200 200 100 150 110 100 100 100 100 100 100 100 100 100 100 100 100 100 100 110 100 110 100 100 100 100 100 100 100 100 110 140 
140 140 140 150 140 140 140 150 140 140 140 150 140 140 140 150 140 140 140 150 150 150 150 250 200 200 200 200 200 200 140 150 140 140 140 150 140 140 140 150 140 140 140 150 140 140 140 150 140 140 140 150 140 140 140 150 140 140 140 150 