Width : 54
Height : 29
Player X : 25
Player Y : 14
Objectives : CA 28,17 EM 0 EM 0 
Weather : 0
120 120 120 120 120 120 120 120 120 120 120 120 120 120 120 120 120 120 120 120 120 120 120 120 120 120 120 120 120 120 120 120 120 120 120 120 120 120 120 120 120 120 120 120 120 120 120 120 120 120 120 120 120 120 
100 100 100 100 100 100 100 100 100 100 100 100 100 100 100 100 100 100 100 100 100 100 100 100 100 100 100 100 100 100 100 100 100 100 100 100 100 100 100 100 100 100 100 100 100 100 100 100 100 100 100 100 100 100 
100 100 150 150 150 150 150 150 200 100 150 150 200 100 150 150 200 100 100 100 150 150 200 100 100 100 150 150 200 100 150 150 200 100 150 150 200 100 150 150 200 100 100 150 150 150 150 200 100 100 100 100 100 100 
100 100 150 150 150 150 150 150 200 100 150 150 200 100 150 150 200 100 100 150 150 150 150 200 100 100 150 150 200 100 150 150 200 100 150 150 200 150 150 150 200 100 150 150 200 100 150 150 200 100 100 100 100 100 
100 100 100 100 150 150 200 100 100 100 150 150 150 150 150 150 200 100 150 150 200 100 150 150 200 100 150 150 150 200 150 150 200 100 150 150 150 150 200 100 100 100 150 150 200 100 100 100 100 100 100 100 100 100 
100 100 100 100 150 150 200 100 100 100 150 150 150 150 150 150 200 100 150 150 150 150 150 150 200 100 150 150 150 150 150 150 200 100 150 150 150 150 200 100 100 100 100 150 150 150 150 200 100 100 100 100 100 100 
100 100 100 100 150 150 200 100 100 100 150 150 200 100 150 150 200 100 150 150 150 150 150 150 200 100 150 150 200 150 150 150 200 100 150 150 200 150 150 200 100 100 100 100 100 100 150 150 200 100 100 100 100 100 
100 100 100 100 150 150 200 100 100 100 150 150 200 100 150 150 200 100 150 150 200 100 150 150 200 100 150 150 200 100 150 150 200 100 150 150 200 100 150 150 200 100 150 150 200 100 150 150 200 100 100 100 100 100 
100 100 100 100 150 150 200 100 100 100 150 150 200 100 150 150 200 100 150 150 200 100 150 150 200 100 150 150 200 100 150 150 200 100 150 150 200 100 150 150 200 100 100 150 150 150 150 200 100 100 100 100 100 100 
100 100 100 100 100 100 100 100 100 100 100 100 100 100 100 100 100 100 100 100 100 100 100 100 100 100 100 100 100 100 100 100 100 100 100 100 100 100 100 100 100 100 100 100 100 100 100 100 100 100 100 100 100 100 
100 100 100 100 100 100 100 100 100 100 100 100 100 100 100 100 100 100 100 100 100 100 100 100 100 100 100 100 100 100 100 100 100 100 100 100 100 100 100 100 100 100 100 100 100 100 100 100 100 100 100 100 100 100 
100 100 100 100 100 000 100 100 000 100 100 100 100 100 100 150 150 150 150 150 150 200 100 100 150 150 150 150 260 100 100 150 150 150 150 150 200 100 100 100 100 100 100 100 000 100 100 000 100 100 100 100 100 100 
100 100 100 100 100 000 100 100 000 100 100 100 100 100 100 150 150 150 150 150 150 200 100 150 150 150 150 150 150 200 100 150 150 200 100 150 150 200 100 100 100 100 100 100 000 100 100 000 100 100 100 100 100 100 
100 100 100 100 100 000 100 100 000 100 100 100 100 100 100 150 150 200 100 100 100 100 100 150 150 200 100 150 150 200 100 150 150 150 150 150 150 200 100 100 100 100 100 100 000 100 100 000 100 100 100 100 100 100 
100 100 100 100 100 100 100 100 100 100 100 100 100 100 100 150 150 150 150 200 100 100 100 150 150 200 100 150 150 200 100 150 150 150 150 150 200 100 100 100 100 100 100 100 100 100 100 100 100 100 100 100 100 100 
100 100 100 100 000 100 100 100 100 000 100 100 100 100 100 150 150 150 150 200 100 100 100 150 150 200 100 150 150 200 100 150 150 150 150 200 100 100 100 100 100 100 100 000 100 100 100 100 000 100 100 100 100 100 
100 100 100 100 100 000 000 000 000 100 100 100 100 100 100 150 150 200 100 100 100 100 100 150 150 150 150 150 150 200 100 150 150 200 150 150 200 100 100 100 100 100 100 100 000 000 000 000 100 100 100 100 100 100 
100 100 100 100 100 100 100 100 100 100 100 100 100 100 100 150 150 200 100 100 100 100 100 100 150 150 150 150 200 100 100 150 150 200 100 150 150 200 100 100 100 100 100 100 100 100 100 100 100 100 100 100 100 100 
100 100 100 100 100 100 100 100 100 100 100 100 100 100 100 100 100 100 100 100 100 100 100 100 100 100 100 100 100 100 100 100 100 100 100 100 100 100 100 100 100 100 100 100 100 100 100 100 100 100 100 100 100 100 
100 100 100 100 100 100 100 100 100 100 100 100 100 100 100 100 100 100 100 100 100 100 100 100 100 100 100 100 100 100 100 100 100 100 100 100 100 100 100 100 100 100 100 100 100 100 100 100 100 100 100 100 100 100 
100 150 150 150 150 200 100 100 150 150 200 100 100 100 100 100 100 100 150 150 200 100 100 100 150 150 200 100 150 150 200 100 150 150 150 150 150 150 200 100 150 150 200 100 150 150 200 100 100 150 150 150 150 100 
150 150 150 150 150 150 200 100 150 150 200 100 100 100 100 100 100 150 150 150 150 200 200 100 150 150 200 100 150 150 200 100 150 150 150 150 150 150 200 100 150 150 200 100 150 150 200 100 150 150 150 150 150 150 
150 150 100 100 150 150 200 100 150 150 200 100 100 100 100 100 150 150 200 100 150 150 200 100 150 150 150 150 150 150 200 100 100 100 150 150 200 100 100 100 150 150 150 200 150 150 200 100 150 150 200 100 150 150 
150 150 150 150 150 150 200 100 150 150 200 100 100 100 100 100 150 150 150 150 150 150 200 100 100 150 150 150 150 200 100 100 100 100 150 150 200 100 100 100 150 150 150 150 150 150 200 100 150 150 200 100 100 100 
150 150 200 100 100 100 100 100 150 150 200 100 100 100 100 100 150 150 250 150 150 150 200 100 100 100 150 150 200 100 100 100 100 100 150 150 200 100 100 100 150 150 200 150 150 150 200 100 150 150 200 100 150 150 
150 150 200 100 100 100 100 100 150 150 150 150 150 150 200 100 150 150 200 100 150 150 200 100 100 100 150 150 200 100 100 100 150 150 150 150 150 150 200 100 150 150 200 100 150 150 200 100 150 150 150 150 150 150 
150 150 200 100 100 100 100 100 150 150 150 150 150 150 200 100 150 150 200 100 150 150 200 100 100 100 150 150 200 100 100 100 150 150 150 150 150 150 200 100 150 150 200 100 150 150 200 100 100 150 150 150 200 150 
100 100 100 100 100 100 100 100 100 100 100 100 100 100 100 100 100 100 100 100 100 100 100 100 100 100 100 100 100 100 100 100 100 100 100 100 100 100 100 100 100 100 100 100 100 100 100 100 100 100 100 100 100 100 
120 120 120 120 120 120 120 120 120 120 120 120 120 120 120 120 120 120 120 120 120 120 120 120 120 120 120 120 120 120 120 120 120 120 120 120 120 120 120 120 120 120 120 120 120 120 120 120 120 120 120 120 120 120 
