Width : 30
Height : 30
Player X : 0
Player Y : 0
Objectives : CA 29,29 SH 13,13 TC 20 
Weather : 1
120 200 120 120 120 120 120 100 100 100 100 110 110 110 100 110 110 100 110 110 110 110 110 100 110 100 110 110 150 160 
100 200 200 120 120 120 100 100 100 100 100 100 100 100 100 100 100 100 100 100 100 100 100 100 100 100 110 140 150 200 
120 200 200 200 120 100 100 100 100 100 100 100 100 100 100 100 100 100 100 100 100 100 100 100 100 100 110 150 150 200 
100 200 200 240 140 100 100 100 110 100 100 100 100 100 100 100 100 100 100 100 110 110 100 100 100 110 140 150 150 200 
220 200 200 140 100 100 100 100 100 100 100 100 100 100 100 100 100 100 100 100 110 110 100 100 100 100 150 150 100 200 
200 100 100 100 100 100 100 100 100 100 100 100 100 100 121 100 121 100 100 100 100 100 100 100 100 110 150 150 100 200 
121 100 100 100 110 100 100 100 100 100 100 100 121 100 100 100 100 100 100 100 100 100 100 100 110 140 150 100 100 200 
200 100 100 100 100 100 100 100 100 100 121 100 100 100 100 100 100 100 100 100 100 100 100 100 100 150 150 100 200 100 
200 100 100 100 100 100 100 100 121 100 100 100 123 100 100 100 100 100 100 100 100 100 100 110 110 150 100 100 200 100 
200 100 100 100 100 100 100 100 100 100 100 100 100 100 100 100 100 100 100 100 100 100 110 140 150 150 100 100 200 100 
121 100 100 100 100 100 100 123 100 100 121 100 100 100 100 100 100 100 100 100 100 120 140 140 150 100 100 200 110 100 
200 100 100 100 100 100 100 100 100 100 100 100 100 100 100 100 100 100 100 100 100 121 140 150 100 100 200 100 100 100 
200 100 100 100 100 100 100 100 100 121 100 100 100 100 100 100 100 100 100 100 100 100 100 100 100 200 100 100 100 140 
200 100 100 100 100 100 100 121 100 100 100 100 100 100 100 100 100 100 100 100 100 100 100 200 200 100 100 100 100 140 
200 100 100 100 100 140 100 100 100 100 100 100 100 100 100 100 100 100 100 100 123 200 200 100 100 100 100 100 140 150 
200 100 100 100 140 140 100 100 100 100 100 100 100 100 100 100 100 100 121 200 200 100 100 100 110 110 100 140 140 150 
110 100 100 100 140 123 100 121 100 200 200 200 200 233 200 200 200 200 200 100 121 100 100 100 110 110 100 140 150 150 
100 110 100 100 100 100 100 100 200 100 100 100 100 100 100 100 100 100 121 100 100 100 100 100 100 100 100 140 140 150 
110 100 100 100 100 100 100 121 200 100 100 100 100 100 100 100 100 100 100 100 100 100 100 100 100 100 100 100 140 150 
100 100 100 100 100 100 100 200 100 100 100 100 100 100 100 100 100 100 100 123 100 100 200 200 100 100 100 100 140 140 
110 100 100 100 100 100 121 200 121 100 100 100 100 100 100 100 100 121 100 100 100 100 200 000 200 100 100 100 100 140 
110 100 100 100 100 100 201 100 100 100 100 100 100 100 100 140 123 100 100 100 100 100 100 200 000 200 200 100 100 100 
100 100 100 100 100 200 121 100 100 100 100 100 100 100 100 100 140 100 100 100 100 100 100 100 200 000 000 200 100 100 
110 100 100 100 200 123 100 100 100 100 100 100 100 100 100 100 100 100 100 100 100 100 110 110 100 200 200 200 100 100 
100 100 100 100 200 100 100 100 121 100 100 100 100 100 100 110 110 100 100 100 100 100 110 110 100 100 100 100 100 100 
100 100 100 200 123 100 100 100 100 100 100 100 100 100 100 110 110 100 100 100 100 100 100 100 100 100 100 100 100 100 
100 100 200 100 100 100 121 100 100 100 100 100 100 100 100 100 100 100 100 100 100 100 100 100 100 100 100 100 100 120 
100 100 200 100 100 100 100 100 121 100 100 100 100 100 100 100 100 100 100 100 100 100 100 100 100 100 100 100 120 120 
100 200 200 140 100 123 100 100 100 100 100 100 100 100 100 100 100 100 100 100 100 100 100 120 100 120 100 120 000 000 
200 200 200 140 140 100 100 123 100 100 120 100 120 100 110 100 110 100 110 100 110 100 120 000 000 000 000 000 000 000 